1111111111111111111111
1C00C000011000C00000P1
101111000CC00001111111
101C00000000M000M000C1
1010111111111111111101
10101E0000000M0000C101
101C111100111100110101
101C0000C000CM0000C101
1C1111111C000001111101
1C00C000C0C000M0000MC1
1111111111111111111111
