11111111111
1P000000011
101100C0101
1C1C00M10E1
11111111111
